1111111111111111111111111111111111111111111111111
1000000000000000000000000000000000000000000000001
1000000000000000000000000000000000000000000000001
1000000000000000000000000000000000000000000000001
1000000000000000000000000000000000000000000000001
1000000000000000000000000000000000000000000000001
1000000000000000000000000000000000000000000000001
1000000000000000000000000000000000000000000000001
1000000001000000000000000000000000000000000000001
1000000001000000001111111110000000000000000000001
1000000001000000000000000000000000000000000000001
1000000001000000000000000000000000000000000000001
1000000001000000000000000000000000000000000000001
1000000001000000000000000000000000000000000000001
1000000001000000000000000000000000000000000000001
1000000001000000000000000000000000000000000000001
1000000001000000000000000000000000000000000000001
1000001001000000010000000000011111111100000000001
1000011100000000010000000000000000000000000000001
1000001000000000010000000000000000000000000000001
1000000000000000010000000000000000000000000000001
1000000000000000010000000000000000000000000000001
1000000000000000010000000000000000000000000000001
1000000000000000000000000000000000000000000000001
1000000000000000000000000000000000000000000000001
1000000000000000000000000000000000000000000000001
1111111111111111111111111111111111111111111111111